bbbbbbbbbbbbb
bwww22222wwwb
bw222222222wb
bbbbb333bbbbb
bbbbb333bbbbb
bwbbbbbbbbbwb
bwwwbbbbbwwwb
bbbbbbbbbbbbb

0000000000000
0000000000000
000000p000000
0000000000000
0000000000000
0000005000000
0000000000000
0000000000000

0020000000000
0000000000000
0011000000002
0002000000000
0000000000000
0000000000100
0000000000000
0020000000000

0000000000000
0000000000000
0000000000000
0000000000000
0000000000000
0000000000000
0000000000000
0000000000000

1
0003
0001
forest
2
13
8
First dungeon
2
0002